000000000111111111000000000
0000000001$1000101000000000
000000000100010001000000000
000000000111010101000000000
000000000110010101000000000
000000000100111101000000000
000000000101111001000000000
000000000100111011000000000
000000000110111011000000000
000000000100001111000000000
000000000101101001000000000
000000000101101001000000000
000000000101101101000000000
000000000101100101000000000
00000000010110000E000000000
222222222222222222222222222