11111111111111111
100000000000000001
100000000000000001
100000000000000001
100000000000000001
100000000000000001
100000000000000001
100000000000000001
100000000000000001
100000000000020001
100000000000000001
100000000000000001
100000000000000001
100000000000000001
100000000000000001
100000000000000001
11111111111111111
