1111111111111111111111111111111111
100000000000000001100000000000000001
100000000000000001100000000000000001
100000000000000001100000000000000001
100000000000000001100000000000000001
100000000000000001100000000000000001
100000000000000001100000000000000001
100000000000000001100000000000000001
100000000000000001100000000000000001
100000000000020001100000000000000001
100000000000000001100000000000000001
100000000000000001100000000000000001
100000000000000001100000000000000001
100000000000000001100000000000000001
100000000000000001100000000000000001
100000000000000001100000000000000001
11111111111111111100000000000000001
11111111111111111101111111100000001
100000000000000001100000000000000001
100000000000000001100000000000000001
100000000000000001100000000000000001
100000000000000001100000000000000001
100000000000000001100000000000000001
100000000000000001101111111100000001
100000000000000001101111111100000001
100000000000000001101111111100000001
100000000000020001101111111100000001
100000000000000001101111111100000001
100000000000000001101111111100000001
100000000000000001101111111100000001
100000000000000001101111111100000001
100000000000000001101111111100000001
100000000000000001101111111100000001
1111111111111111111111111111111111
