111111111
1$2000101
100010001
111010101
110010101
100111101
101111001
100111011
110111011
100001111
101101001
101101001
101101101
101100101
101100000
222222222