222222222222222222222222222222222222222222222222222222
2000000001$1000101000000000000000001010001010000000002
200000000100010001000000000000000001010001010000000002
200000000111010101000000000000000000010001010000000002
200000000110010101000000000000000000010001010000000002
200000000100111101000000000000000001010001010000000002
200000000101111001000000000000000001010001010000000002
200000000100111011000000000000000001000001010000000002
200000000110111000000000000000000001010001010000000002
200000000100001111000000000000000001010001010000000002
200000000101101001000000000000000001010001010000000002
200000000101101001000000000000000001010001010000000002
200000000101101101000000000000000001010001010000000002
200000000101100101000000000000000001010001010000000002
20000000010110000E000000000000000001000010100000000002
222222222222222222222222222222222222222222222222222222
