22222222222222222222
2$040500405000445002
20140040200400440402
20040040400400440402
20040040454400440402
20040040400200440402
20040040400400440402
21040140411400441412
20040040400400440402
20040040400400000402
20040040400400000402
20040040400400000452
20044041400400000402
20004040400400000402
20055045000400000432
22222222222222222222
