22222222222222222222222222222222222222222222222222
2$004000000000000000000000000000000000000000000002
20004000000000000000000000000000000000000000000002
20004000000000000000000000000000000000000000000002
20004000000000000000000000000000000000000000000002
20004000000000000000000000000000000000000000000002
20004000000000000000000000000000000000000000000002
21104000000000000000000000000000000000000000000002
20000000400000000000000000000000000000000000000002
20000000400000000000000000000000000000000000000002
20000000400000000000000000000000000000000000000002
20000000400000000000000000000000000000000000000002
20000000400000000000000000000000000000000000000002
20000000400000000000000000000000000000000000000002
25550000400000000000000000000000000000000000000032
22222222222222222222222222222222222222222222222222
