22222222222222222222222222222222222222222222222222
2$004555000045550000455500004555000045550000400002
20104000000040000000400000004000000040000000400002
20004000000040000000400000004000000040000000400002
20004000000040000000400000004000000040000000400002
20004000000040000000400000004000000040000000400002
20004000000040000000400000004000000040000000400002
21014111000041110000411100004111000041110000400002
20000000400000004000000040000000400000004000000002
20000000400000004000000040000000400000004000000002
20000000400000004000000040000000400000004000000002
20000000400000004000000040000000400000004000000002
20000000400000004000000040000000400000004000000002
20000000400000004000000040000000400000004000000002
25550000000000000000000000000000000000000000000032
22222222222222222222222222222222222222222222222222
